mauer.png bauplatz.png
z o o o o o o o o
x x x x x x x x o
o o o o o o o o o
o x x x x x x x x
o o o o o o o o o
x x x x x x x x o
s o o o o o o o o